EQS	= "countries/Equestria.txt"
CRY	= "countries/Crystal Empire.txt"
TSU	= "countries/Chrysalis.txt"
THR	= "countries/Thorax.txt"
CHA = "countries/Generic Changeling.txt"
CHB = "countries/Generic Changeling 2.txt"
CHC = "countries/Generic Changeling 3.txt"
CHD = "countries/Generic Changeling 4.txt"
CHE = "countries/Generic Changeling 5.txt"
YAK = "countries/Yakyakistan.txt"
BIG = "countries/Soviet Hoofsia.txt"
GPA = "countries/Generic Pony 1.txt"
GPB = "countries/Generic Pony 2.txt"
GPC = "countries/Generic Pony 3.txt"
GPD = "countries/Generic Pony 4.txt"
EQA = "countries/Equestrian Ally.txt"
GPE = "countries/Generic Pony 5.txt"
GPF = "countries/Generic Pony 6.txt"
GPG = "countries/Generic Pony 7.txt"
BAT = "countries/Thestryska.txt"
BPA = "countries/Bat Pony 1.txt"
BPB = "countries/Bat Pony 2.txt"
BPC = "countries/Bat Pony 3.txt"
SPE = "countries/Spane.txt"
ZEB = "countries/Zebrazil.txt"
ARC = "countries/Austrebra.txt"
DES = "countries/Burn me.txt"
DEL = "countries/Starkattererra.txt"
ZLA = "countries/Zebuela.txt"
ROM = "countries/Roam.txt"
AGG = "countries/Aquaggsus.txt"
HIG = "countries/Highlander Ponies.txt"
PEG = "countries/Pegaclave.txt"
KBR = "countries/Kingdom of Borrerun.txt"
KAN = "countries/Kingdom of Anrush.txt"
KRA = "countries/Kingdom of Ralih.txt"
KET = "countries/Republic of Ethoh.txt"
IMJ = "countries/Imihian Military Junta.txt"
VEN = "countries/Soveni.txt"
SCD = "countries/People's Republic of Cervidia.txt"
NDR = "countries/Northern Deer Republic.txt"
EDC = "countries/Eastern Deer Clans.txt"
OUT = "countries/Deer Outcasts.txt"
DRG = "countries/Dragons.txt"
CER = "countries/Cervidia.txt"
JDC = "countries/Jungle Deer Clans.txt"
SDN = "countries/Smart Deer.txt"
EQF = "countries/Equestrian Frontier.txt"
BUF = "countries/Buffalo Tribes.txt"
SAD = "countries/Saddle Arabia.txt"
KIR = "countries/Kirins.txt"
MEG = "countries/Maregypt.txt"
GRI = "countries/Griffonstone.txt"
KOB = "countries/Kingdom of Bronsfeather.txt"
GGA = "countries/Generic Griffon 1.txt"
GGB = "countries/Generic Griffon 2.txt"
EQC = "countries/Equestrian Colony.txt"
NGF = "countries/New Griffonstone.txt"
ZEC = "countries/Zebra Colony.txt"
POC = "countries/Pony Colony.txt"
SPV = "countries/Viceroy 1.txt"
SPW = "countries/Viceroy 2.txt"
SPX = "countries/Viceroy 3.txt"
PAN = "countries/Panama ponies.txt"
SPA = "countries/Southern pony.txt"
SPC = "countries/Southern pony.txt"
MUT = "countries/Mutant Monkeys.txt"
SAT = "countries/Star Bears.txt"
FOX = "countries/Star Foxes i mean Wolves.txt"
ZRU = "countries/Zrussia.txt"
PAR = "countries/Parrots or something.txt"
THE = "countries/Thermonia.txt"
CAT = "countries/Abyssinia.txt"
SPD = "countries/Southern Pony.txt"
HIP = "countries/Hippogriffs.txt"
THC = "countries/Thestrykan Colony.txt"
RNG = "countries/Rich Penguins.txt"
APN = "countries/Angry Penguins.txt"
BPN = "countries/Southern Penguins.txt"
BAP = "countries/Bat Culture Penguins.txt"
NPN = "countries/Northern penguins.txt"
OPN = "countries/Old Penguins.txt"
NNP = "countries/North North Penguins.txt"
FPN = "countries/Frozen Penguins.txt"
PCF = "countries/Penguin Confederation.txt"
XXX = "countries/Scary.txt"